5 5 5 5 5 5 5 5 5 5 5 5 5 5 5 5 5 5 5 5 5 5 5 5 5
5 5 1 2 1 5 5 5 5 5 5 5 5 5 5 1 1 1 1 1 1 1 1 1 5
5 5 1 4 1 5 5 5 5 5 5 5 5 5 5 5 5 5 5 5 5 5 5 2 5
5 5 1 1 1 5 5 5 5 5 5 5 5 5 5 5 5 5 5 5 5 5 5 1 5
5 5 5 5 5 5 5 5 5 5 5 5 5 5 5 5 5 5 5 5 5 5 5 2 5
5 1 1 1 5 5 5 5 5 5 5 5 5 5 5 5 5 5 5 5 5 5 5 1 5
5 1 1 1 5 5 1 2 1 1 5 5 5 1 1 1 1 1 1 1 5 5 5 2 5
5 1 5 5 5 5 5 5 1 4 5 5 5 1 1 1 5 5 1 1 1 1 1 1 5
5 1 5 5 1 1 1 5 1 1 5 5 5 1 1 1 5 5 1 1 1 1 1 1 5
5 1 1 1 1 5 5 5 5 1 5 5 5 2 1 1 5 5 1 1 4 1 1 1 5
5 5 5 5 1 5 5 5 5 1 5 5 5 1 1 1 5 5 1 1 1 1 1 1 5
5 5 5 5 2 5 5 5 5 5 5 5 5 1 1 1 5 5 5 5 1 1 1 1 5
5 5 1 2 1 5 5 5 1 2 1 5 5 1 1 1 5 5 5 1 1 1 1 1 5
5 5 1 1 5 5 5 5 1 1 1 5 5 5 5 5 5 5 1 1 1 1 2 1 5
5 5 1 1 5 5 5 5 1 1 1 5 5 5 5 5 5 5 3 3 3 3 3 3 5
5 5 1 1 5 5 5 5 1 4 1 1 1 2 1 5 5 5 5 3 3 3 3 3 5
5 5 1 1 5 5 5 5 1 1 1 1 1 5 5 5 5 5 5 5 3 3 3 3 5
5 5 1 2 5 5 5 5 5 5 5 5 5 5 5 5 5 5 5 5 3 3 4 3 5
5 5 2 1 5 5 5 5 5 5 5 5 5 5 5 5 5 5 5 5 3 3 2 3 5
5 5 1 1 5 5 1 1 1 1 1 2 1 1 1 1 1 1 1 1 3 3 3 3 5
5 5 1 5 5 5 5 5 5 5 1 1 4 1 1 1 1 1 1 1 3 3 3 3 5
5 1 1 5 1 1 1 5 5 5 1 5 1 5 5 5 7 5 1 5 5 5 5 5 5
5 1 1 5 5 5 1 5 1 5 1 5 1 5 1 1 1 5 5 5 1 1 1 1 5
5 1 2 1 1 1 1 4 1 5 1 2 1 5 1 9 1 5 5 5 1 4 1 1 5
5 5 5 5 5 5 5 5 5 5 5 5 5 5 5 5 5 5 5 5 5 5 5 5 5