5 5 5 5 5 5 5 5 5 5 5 5 5 5 5 5 5 5 5 5 5 5 5 5 5
5 5 1 2 1 5 5 5 5 5 5 5 5 5 5 9 1 1 1 1 7 1 1 1 5
5 5 1 1 5 5 5 5 5 5 5 5 5 5 5 5 5 5 5 5 5 5 5 2 5
5 5 1 1 5 5 5 5 5 5 5 5 5 5 5 5 5 5 5 5 5 5 5 1 5
5 1 1 2 5 5 5 5 5 5 5 5 5 5 5 5 5 5 5 5 5 5 5 2 5
5 1 1 1 5 5 5 5 5 5 5 5 5 5 5 5 5 5 5 5 5 5 5 1 5
5 1 1 1 1 5 1 1 1 1 1 1 1 1 1 1 1 1 1 1 5 5 5 2 5
5 1 1 5 5 5 5 5 1 1 1 1 1 1 1 1 5 5 1 1 1 1 1 1 5
5 1 1 1 1 1 5 5 1 1 1 1 1 1 1 1 5 5 1 1 1 1 1 1 5
5 5 5 5 1 5 5 5 5 1 1 1 1 2 1 1 5 5 1 1 1 1 1 1 5
5 5 5 5 1 1 5 5 5 1 1 1 1 1 1 1 5 5 1 1 1 1 1 1 5
5 5 5 5 2 5 5 5 5 5 5 5 5 1 1 1 5 5 5 5 1 1 1 1 5
5 1 1 1 1 1 5 5 1 2 1 1 1 1 1 1 1 1 1 1 1 1 1 1 5
5 1 1 1 1 1 5 5 1 1 1 1 1 1 1 5 5 5 1 1 1 1 2 1 5
5 1 1 1 1 1 5 5 1 1 1 1 1 1 1 5 5 5 1 1 1 1 1 1 5
5 1 1 1 1 1 5 5 1 1 1 1 1 2 1 5 5 5 5 1 1 1 1 1 5
5 1 1 1 1 1 5 5 1 1 1 1 1 5 5 5 5 5 5 5 1 1 1 1 5
5 1 1 2 1 1 5 5 5 5 5 5 5 5 5 5 5 5 5 5 1 1 1 1 5
5 1 1 1 1 1 5 5 5 5 5 5 5 5 5 5 5 5 5 5 1 1 2 1 5
5 1 1 1 1 1 1 1 1 1 1 2 1 1 1 1 1 1 1 1 1 1 1 1 5
5 1 1 5 5 5 1 5 1 5 1 5 1 5 5 5 1 5 1 1 1 1 1 1 5
5 1 1 5 1 1 1 5 5 5 1 5 1 5 5 5 1 5 1 1 1 1 1 1 5
5 1 1 5 5 5 1 5 1 5 1 5 1 5 1 1 1 1 1 2 1 1 1 1 5
5 1 1 1 1 1 1 1 1 1 1 2 1 1 1 1 1 5 1 1 1 1 1 1 5
5 5 5 5 5 5 5 5 5 5 5 5 5 5 5 5 5 5 5 5 5 5 5 5 5